XXXXXXXXXXXXXX
XXX-----XX--XX
X-P-XX-----XXX
X--X---XX----X
XX----X----XXX
XX--XX----XXXX
XX---XX---X--F
X--XXX---X---F
X-XXXX---X---F
X--XXX--X--X-X
X---X--X--XX-X
X---XX----X--X
XX--X---XXX--X
X------XXXXXXX
XXXXXXXXXXXXXX
